. . . . * . . . . . * * . * * * * . . * * * . . * . * * * . 
* * * * . . . . . . * . . . . . * . * * . . * * . . . . * . 
. * . . . . . . * * . . . . . * . . . g * . . . * * * . * * 
* . . . . * * . * . . * * . . . . . . . . . . * . . . . . . 
* * . . . . * . * . . * . . . . . . . . * * . . . . . * * . 
* . . . . . . . * . * . * * . * . . . * * * . . * * * * * . 
* * * . * . . . . . . . . * . * * . . * * * * . . . . * * . 
* * . * * . * . . . . . . * . . . * . . * . . . . . * . * . 
. * . . . * . * * * . . * . * . . * * * . . * . * * . . . . 
. . * . * * . . * . . * . * . . * * . . . . . . * * . . * . 
. . . * * . * . * . . * . . * . * . * * * . . . . . . . . . 
. . . * . . . . . . . . . . * . . . * . . . . . * . . . . * 
. * . * * * . * * . . * * * * * . . . * . . . * . . . . . . 
. * . * * * * * . . . . * . . * * * * * . . * * . . * . . . 
* * * . * . . . . * . . * . . . . * * * * . . . * . . * * * 
* . . * * . . * . . . * . . . . . . . . * * . * . . . . . * 
* . . . * * . * * . * * . * . . . . . . . . . * * . * * . * 
* * * * . . . . . . . * * * * * . * . . . . . . * * . * . . 
* * . . . . * * . . * * * . . . . . . . * . . * * . . . s * 
. . * * * * * * * . * . * . * . * * * . * . . . . . . . . .
