* . . * * . . . . . 
g . . . . . . . * * 
. * . * . * * * . . 
. * . * * s . . . * 
. . . . * . * * . . 
. . * * . . . . . * 
. . . . . . * . . * 
. * * . . * * * . . 
. . * . . . . . * * 
* * . . * . . * * . 
